20230826	서울대학교대학원	16	154	83	776	99	930
20230904	서울대학교대학원	16	149	83	762	99	911
20230911	서울대학교대학원	16	148	83	749	99	897
20230921	서울대학교대학원	17	148	83	744	100	892
20231001	서울대학교대학원	17	147	83	743	100	890
20231011	서울대학교대학원	17	147	83	742	100	889
20231021	서울대학교대학원	17	148	83	741	100	889
20231101	서울대학교대학원	17	147	83	740	100	887
20231111	서울대학교대학원	17	147	83	740	100	887
20231121	서울대학교대학원	17	147	83	740	100	887
20231201	서울대학교대학원	17	147	83	739	100	886
20231211	서울대학교대학원	29	158	149	805	178	963
20231221	서울대학교대학원	29	158	149	805	178	963
20240101	서울대학교대학원	0	158	0	804	0	962
20240111	서울대학교대학원	0	158	0	804	0	962
20240121	서울대학교대학원	0	158	0	804	0	962
20240201	서울대학교대학원	0	143	0	709	0	852
20240211	서울대학교대학원	0	143	0	708	0	851
20240221	서울대학교대학원	0	143	0	709	0	852
20240301	서울대학교대학원	0	141	0	687	0	828
20240311	서울대학교대학원	0	141	0	687	0	828
20240321	서울대학교대학원	0	137	0	665	0	802
20240401	서울대학교대학원	0	137	0	663	0	800
20240411	서울대학교대학원	0	137	0	658	0	795
20240421	서울대학교대학원	0	137	0	658	0	795
20240501	서울대학교대학원	0	137	0	657	0	794
20240511	서울대학교대학원	0	136	0	657	0	793
20240521	서울대학교대학원	0	136	0	657	0	793
20240601	서울대학교대학원	0	136	0	657	0	793
20240611	서울대학교대학원	0	136	0	657	0	793
20240621	서울대학교대학원	0	135	0	657	0	792
20240624	서울대학교대학원	0	135	0	657	0	792
20240624	서울대학교대학원	0	135	0	657	0	792
20240701	서울대학교대학원	0	135	0	657	0	792
