20230826	울산과학기술원	1	61	56	183	57	244
20230904	울산과학기술원	1	60	56	182	57	242
20230911	울산과학기술원	1	60	56	180	57	240
20230921	울산과학기술원	1	60	56	180	57	240
20231001	울산과학기술원	1	60	56	180	57	240
20231011	울산과학기술원	1	60	56	179	57	239
20231021	울산과학기술원	1	60	56	179	57	239
20231101	울산과학기술원	1	60	56	179	57	239
20231111	울산과학기술원	1	59	56	179	57	238
20231121	울산과학기술원	1	59	56	179	57	238
20231201	울산과학기술원	1	59	56	179	57	238
20231211	울산과학기술원	1	59	58	180	59	239
20231221	울산과학기술원	1	59	58	180	59	239
20240101	울산과학기술원	0	58	0	180	0	238
20240111	울산과학기술원	0	57	0	180	0	237
20240121	울산과학기술원	0	56	0	180	0	236
20240201	울산과학기술원	0	54	0	180	0	234
20240211	울산과학기술원	0	54	0	180	0	234
20240221	울산과학기술원	2	56	30	210	32	266
20240301	울산과학기술원	2	47	30	152	32	199
20240311	울산과학기술원	2	46	30	150	32	196
20240321	울산과학기술원	2	45	30	150	32	195
20240401	울산과학기술원	2	45	30	150	32	195
20240411	울산과학기술원	2	45	30	149	32	194
20240421	울산과학기술원	2	45	30	149	32	194
20240501	울산과학기술원	2	45	30	149	32	194
20240511	울산과학기술원	2	45	30	149	32	194
20240521	울산과학기술원	2	45	30	149	32	194
20240601	울산과학기술원	2	45	30	149	32	194
20240611	울산과학기술원	2	45	30	149	32	194
20240621	울산과학기술원	2	45	30	149	32	194
20240624	울산과학기술원	2	45	30	149	32	194
20240624	울산과학기술원	2	45	30	149	32	194
20240701	울산과학기술원	2	45	30	149	32	194
20240711	울산과학기술원	2	45	30	149	32	194
20240721	울산과학기술원	2	45	30	149	32	194
20240801	울산과학기술원	2	45	30	148	32	193
20240811	울산과학기술원	4	41	48	165	52	206
